{
    "type": "tile",
    "size": [12288, 12288],
    "alpha": false,
    "tiles": [
        [
            "1_1.png",
            "2_1.png",
            "3_1.png",
            "4_1.png",
            "5_1.png",
            "6_1.png"
        ],
        [
            "1_2.png",
            "2_2.png",
            "3_2.png",
            "4_2.png",
            "5_2.png",
            "6_2.png"
        ],
        [
            "1_3.png",
            "2_3.png",
            "3_3.png",
            "4_3.png",
            "5_3.png",
            "6_3.png"
        ],
        [
            "1_4.png",
            "2_4.png",
            "3_4.png",
            "4_4.png",
            "5_4.png",
            "6_4.png"
        ],
        [
            "1_5.png",
            "2_5.png",
            "3_5.png",
            "4_5.png",
            "5_5.png",
            "6_5.png"
        ],
        [
            "1_6.png",
            "2_6.png",
            "3_6.png",
            "4_6.png",
            "5_6.png",
            "6_6.png"
        ]
    ]
}